1111111111
1000000001
1E0C0C0P01
1001000001
1111111111