1111111111
10C0000001
1E01001001
100100P001
1111111111