1111111111
10C00000C1
1E01001001
100100P0C1
1111111111