1111111111
1000000001
1E01000001
100110PC01
1111111111